111111111111111
150000000000001
100000000000001
100000000000001
100000000000001
106000000000001
106000000000001
111111101111111
190000000000091
100000000000001
100000000000001
100000000000001
100000000000001
100000000000001
111111111111111

-Scores Table-
