00040
7 7
***************
*             *
*        X    *
*             *
*             *
*       B     *
*****       ***
*             *
*    B        *
*             *
*  X          *
*             *
*             *
*             *
***************
