1111111111111111111
1500000000000000001
1000000000000600001
1000000000000000001
1000000000000111111
1000000000000000091
1000600000000111111
1000000000000000001
1000000000000000001
1111110000000000001
1090000000000000001
1111110000000000001
1000000000000000001
1111111000000000001
1000001000000000001
1000000000006000001
1000001000000000001
1900001000000000001
1111111111111111111

---Scores Table---
