+ + + + + + + + + + + + + + + + + + +
+ #                                 +
+                         @         +
+                                   +
+                         + + + + + +
+                               *   +
+       @                 + + + + + +
+                                   +
+                                   +
+ + + + + +                         +
+   *                               +
+ + + + + +                         +
+                                   +
+ + + + + + +                       +
+           +                       +
+                         @         +
+           +                       +
+ *         +                       +
+ + + + + + + + + + + + + + + + + + +

--------Scores Table---------
