99999
7 6
***************
*             *
*   X   **    *
*         * B *
*           ***
*       B     *
*****       ***
*             *
*    B        *
*  ******     *
*   X  **     *
*      **     *
*       X     *
*             *
***************
