2 1 1 5 2
2 6 2 4 2
2 2 2 3 2
2 2 2 2 2
2 2 2 2 2