2 2 2 3 4
2 2 1 1 5
2 2 1 2 2
2 2 1 1 2
2 2 2 6 2