0 0 0 0 0 0 0 0 0 0 0 0 0 0 0
0 0 0 0 0 0 0 0 0 0 0 0 0 0 0 
0 0 0 0 0 0 0 0 0 0 0 0 0 0 0 
0 0 0 0 0 0 0 0 0 0 0 0 0 0 0 
0 0 0 0 0 0 0 0 4 0 0 0 0 0 0 
0 0 0 0 0 4 4 4 9 4 0 0 0 0 0 
0 0 0 0 4 0 0 0 0 0 4 0 0 0 0 
0 0 0 4 0 5 6 6 6 0 9 4 0 0 0 
0 0 0 0 4 0 0 0 0 0 4 0 0 0 0 
0 0 0 0 0 4 4 4 9 4 0 0 0 0 0 
0 0 0 0 0 0 0 0 4 0 0 0 0 0 0 
0 0 0 0 0 0 0 0 0 0 0 0 0 0 0 
0 0 0 0 0 0 0 0 0 0 0 0 0 0 0 
0 0 0 0 0 0 0 0 0 0 0 0 0 0 0 
0 0 0 0 0 0 0 0 0 0 0 0 0 0 0 
3 
5 7