0 0 0 0 0 0 0 0 0 0 0 0 0 0 0
0 0 0 0 0 0 0 0 0 0 0 0 0 0 0
0 0 0 0 0 0 0 0 0 0 0 0 0 0 0
0 0 0 0 0 0 4 4 0 0 0 0 0 0 0
0 0 0 0 0 4 0 0 4 0 0 0 0 0 0
0 0 0 0 4 0 6 0 4 0 0 0 0 0 0
0 0 0 4 0 0 6 0 4 4 4 4 0 0 0
0 0 0 4 0 4 5 0 0 0 0 0 4 0 0
0 0 0 4 0 0 6 4 4 4 4 0 4 0 0
0 0 0 4 9 0 0 0 0 0 0 9 0 4 0
0 0 0 0 4 9 0 4 4 4 4 4 4 0 0
0 0 0 0 0 4 4 0 0 0 0 0 0 0 0
0 0 0 0 0 0 0 0 0 0 0 0 0 0 0
0 0 0 0 0 0 0 0 0 0 0 0 0 0 0
0 0 0 0 0 0 0 0 0 0 0 0 0 0 0 
3
6 7
