9  9  3  1  1
3  7  3
4  7  3
5  7  3
1 1 1 1 1 0 0 0 0
1 0 0 0 1 0 0 0 0
1 0 53 53 1 0 1 1 1
1 0 53 0 1 0 1 3 1
1 1 1 0 1 1 1 3 1
0 1 1 0 0 0 0 3 1
0 1 0 0 0 1 0 0 1
0 1 0 0 0 1 1 1 1
0 1 1 1 1 1 0 0 0