13  16  17  9  6
2  6  2
3  5  2
3  6  2
4  4  2
4  5  2
4  6  2
5  4  2
5  6  2
9  2  2
9  3  2
9  4  2
10  2  2
10  3  2
10  4  2
11  2  2
11  3  2
11  4  2
0 0 0 0 0 0 1 1 1 1 1 0 0 0 0 0
1 1 1 1 1 1 1 0 0 0 1 0 0 0 0 0
1 0 0 0 1 1 2 0 0 0 1 0 0 0 0 0
1 0 0 52 1 2 2 0 0 1 1 1 0 0 0 0
1 1 0 0 2 2 2 1 52 52 0 1 1 1 1 1
0 1 0 52 2 1 2 52 0 0 0 0 0 0 0 1
0 1 0 52 1 1 1 52 1 1 0 1 0 52 0 1
0 1 0 0 0 1 0 0 0 0 0 52 52 1 0 1
0 1 1 52 52 1 0 1 1 52 1 52 0 0 0 1
0 1 2 2 2 52 0 0 0 52 0 0 0 1 1 1
0 1 2 2 2 1 52 1 0 0 0 1 1 1 0 0
0 1 2 2 2 0 0 1 1 1 1 1 0 0 0 0
0 1 1 1 1 1 1 1 0 0 0 0 0 0 0 0