14  16  17  9  5
1  1  3
1  2  3
1  3  3
2  1  3
2  2  3
2  3  3
3  1  3
3  2  3
3  3  3
3  4  3
4  2  3
4  3  3
4  4  3
4  5  3
5  3  3
5  4  3
5  5  3
1 1 1 1 1 0 1 1 1 1 0 0 0 0 0 0
1 3 3 3 1 0 1 0 0 1 1 1 1 0 0 0
1 3 3 3 1 1 1 0 0 53 0 0 1 0 0 0
1 3 3 3 3 1 1 0 53 0 0 53 1 1 1 0
1 1 3 3 3 3 1 1 0 0 0 53 0 0 1 0
1 1 1 3 3 3 0 1 1 0 53 0 53 0 1 0
1 0 1 1 0 0 0 0 1 0 0 53 0 0 1 0
1 0 0 1 1 0 1 0 1 1 1 0 1 1 1 1
1 0 53 0 1 0 1 53 0 0 53 0 0 0 0 1
1 0 0 53 0 0 0 53 0 0 0 0 53 0 0 1
1 0 0 0 1 0 53 0 53 53 0 53 0 1 1 1
1 0 0 1 1 1 1 1 1 0 0 1 1 1 0 0
1 0 1 1 0 0 0 0 1 1 1 1 0 0 0 0
1 1 1 0 0 0 0 0 0 0 0 0 0 0 0 0