14  15  10  1  1
10  5  2
11  5  2
12  5  2
10  6  2
11  6  2
12  6  2
10  7  2
11  7  2
12  7  2
13  7  2
1 1 1 1 1 0 0 0 0 0 0 1 1 1 1
1 0 0 0 1 1 1 1 1 1 1 1 0 0 1
1 1 0 52 0 0 0 0 0 0 0 52 0 0 1
0 1 0 1 0 1 0 0 1 1 1 1 0 0 1
0 1 0 0 52 0 0 0 1 1 1 1 52 1 1
0 1 52 0 1 1 0 1 0 52 0 52 0 1 0
1 1 0 52 0 0 52 1 0 0 0 0 0 1 0
1 0 0 0 1 0 0 0 0 0 0 1 0 1 0
1 0 0 0 1 1 1 1 1 52 1 1 1 1 0
1 1 1 1 1 0 0 0 1 0 0 0 1 0 0
0 0 0 0 1 2 2 2 0 0 52 0 1 0 0
0 0 0 0 1 2 2 2 0 1 0 0 1 0 0
0 0 0 0 1 2 2 2 2 1 1 1 1 0 0
0 0 0 0 1 1 1 1 1 1 0 0 0 0 0