12  14  13  7  3
2  7  4
3  6  4
3  10  4
3  11  4
4  4  4
4  5  4
4  8  4
5  7  4
5  11  4
6  8  4
7  6  4
8  7  4
9  5  4
0 0 0 0 1 1 1 1 1 1 0 0 0 0
0 0 1 1 1 0 0 0 0 1 1 1 0 0
0 0 1 0 0 0 1 54 0 0 0 1 1 1
0 0 1 0 0 0 54 0 0 0 54 54 0 1
0 0 1 0 54 54 0 1 54 0 0 0 0 1
0 0 1 1 0 0 0 54 0 0 0 54 0 1
1 1 1 1 1 1 0 1 54 1 1 1 1 1
1 4 4 0 0 1 54 0 0 1 0 0 0 0
1 4 1 4 4 0 0 54 1 1 0 0 0 0
1 4 4 4 4 54 1 0 1 0 0 0 0 0
1 4 4 4 4 0 0 0 1 0 0 0 0 0
1 1 1 1 1 1 1 1 1 0 0 0 0 0