8  8  4  4  4
1  3  2
4  1  3
3  6  4
6  4  4
0 0 1 1 1 0 0 0
0 0 1 2 1 0 0 0
0 0 1 0 1 1 1 1
1 1 1 52 0 54 4 1
1 3 0 53 0 1 1 1
1 1 1 1 54 1 0 0
0 0 0 1 4 1 0 0
0 0 0 1 1 1 0 0