13  15  11  7  8
4  1  3
4  2  3
5  1  3
5  2  3
6  1  3
6  2  3
7  1  3
7  2  3
8  1  3
8  2  3
9  2  3
1 1 1 1 0 0 0 0 0 0 0 0 0 0 0
1 0 0 1 0 0 0 0 0 0 0 0 0 0 0
1 0 0 1 1 1 1 1 1 1 1 1 1 0 0
1 0 0 0 0 1 1 0 0 0 0 0 1 0 0
1 3 3 1 0 0 0 0 53 53 1 0 1 0 0
1 3 3 0 0 1 1 0 0 0 53 0 1 1 1
1 3 3 1 0 0 1 1 53 1 0 53 0 0 1
1 3 3 0 0 0 1 0 0 53 0 53 0 0 1
1 3 3 1 0 0 1 0 53 0 53 0 0 0 1
1 0 3 0 0 0 1 0 53 0 53 0 1 1 1
1 0 0 1 0 0 1 0 0 0 1 1 1 0 0
1 0 0 1 0 0 0 0 1 1 1 0 0 0 0
1 1 1 1 1 1 1 1 1 0 0 0 0 0 0