9  11  6  7  8
4  4  2
4  5  2
4  6  2
5  4  2
5  5  2
5  6  2
0 1 1 1 1 1 1 1 1 1 0
0 1 0 0 1 1 0 0 0 1 0
0 1 0 0 0 52 0 0 0 1 0
0 1 52 0 1 1 1 0 52 1 0
0 1 0 1 2 2 2 1 0 1 0
1 1 0 1 2 2 2 1 0 1 1
1 0 52 0 0 52 0 0 52 0 1
1 0 0 0 0 0 1 0 0 0 1
1 1 1 1 1 1 1 1 1 1 1