0 0 0 0 0 2 2 2 2
0 1 2 2 0 2 2 2 2
0 2 4 4 0 2 0 0 0
0 2 4 2 0 2 0 3 0
0 0 0 2 0 0 0 3 0
2 0 0 2 2 2 2 3 0
2 0 2 2 2 0 2 2 0
2 0 2 2 2 0 0 0 0
2 0 0 0 0 0 2 2 2

7 7 7
3 4 5

2 0 0 0 0 0 0 0 2
2 0 2 2 0 0 0 0 2
2 0 1 4 2 2 0 0 2
0 0 0 2 0 2 0 0 2
0 3 0 2 0 2 2 0 2
0 3 4 2 2 0 2 0 2
0 3 2 2 2 4 2 0 2
0 0 0 0 0 0 0 0 2
2 2 2 2 2 2 2 2 2

1 1 1
4 5 6

