1 1 1 1 1 1 1 1
1 0 0 0 3 1 1 1
1 0 2 0 0 1 1 1
1 1 0 0 0 0 0 1
1 1 0 0 0 0 0 1
1 0 0 0 0 1 1 1
1 0 4 5 0 1 1 1
1 1 1 1 1 1 1 1

20 30