1 1 1 1 1 1 1 1 
1 1 0 0 0 0 1 1 
1 0 0 0 0 4 3 1
1 5 2 0 0 0 0 1
1 0 0 1 0 0 0 1
1 0 2 1 0 0 0 1
1 0 0 1 0 3 1 1
1 1 1 1 1 1 1 1

50 70