        0                         
4                                 
1111111111111111111111111111111111
1111111111111111111111111111111111
            8                     
1111111111111111111111111111111111
1111111111111111111111111111111111
1111111111111111111111111111111111
1111111111111111111111111111111111
1111111111111311111111111111111111
1111111111111    11111111111111111
1111111111111 1     11111111111111
1111111111111 15111 11111111111111
1111111111111 5 5   31111111111111
11111111111115   1  31111111111111
1111111111111111111111111111111111
1111111111111111111111111111111111
1111111111111111111111111111111111
1111111111111111111111111111111111
1111111111111111111111111111111111