4 4
8 8
0 0 0 0 0 0 0 0
0 0 0 4 0 0 0 0
0 0 0 1 0 0 0 0
0 0 0 3 1 3 4 0
0 4 1 3 2 0 0 0
0 0 0 0 3 0 0 0
0 0 0 0 4 0 0 0
0 0 0 0 0 0 0 0