8 8
-2 -2  1  1  1 -2 -2 -2
-2 -2  1 -1  1 -2 -2 -2
-2 -2  1  0  1  1  1  1
 1  1  1  2  0  2 -1  1
 1 -1  0  2 -3  1  1  1
 1  1  1  1  2  1 -2 -2
-2 -2 -2  1 -1  1 -2 -2
-2 -2 -2  1  1  1 -2 -2

