1111111111
2000000001
1111111101
1111111101
1111111101
1111111101
1111111101
1111111101
3000000001
1111111111