OOOOOOOOOO
OXXXXXXXXO
OBOOXOXXXO
OXXOOOOXXO
OXXOXXOOXO
OXOOXOXOXO
OXXOOOOXXO
OXOOXXOOAO
OXXXXXXXXO
OOOOOOOOOO
