111111111111111
150000001000001
101111101011101
101000101010001
101000101010101
101000101010101
101111101010101
100000101011101
101110101010001
100010101010111
100010111010111
100010000010001
101111111111101
100000000000101
111111111111181
