            0                     
4                                 
1111111111111111111111111111111111
11   1   1   1   1   1   1   1   1
1  1   1   1   1   1   1   1   1 1
2 1111111111111111111111111111 1 1
11111                11        1 1
11111 111111111 1111    111111 1 1
3 111    1    1 1   11 11   11 1 1
1  11111 1 11 1 1 1    11 1 11 1 1
11  1111  111 1 1 1111    1    1 1
111 1  11   1   1    11111111111 1
1     11111  1111111 1    111111 1
1 1 11    11 1    11 1 11 1  1   1
1 1    11 11 1 11 11 1 11 1 1111 1
111111 11 1  1 11    1  1 1   11 1
1    1 11 1 11 11111111111111 11 1
1 11   11 1  1 111111    1111 1  1
1  111111   11       111      1111
1111111111111111111111111111111111s