+ + + + + + + + + + + + + + +
+ #                         +
+                           +
+                           +
+                           +
+   @                       +
+   @                       +
+ + + + + + +   + + + + + + +
+ *                       * +
+                           +
+                           +
+                           +
+                           +
+                           +
+ + + + + + + + + + + + + + +

--------Scores Table---------
