8 8 4 4 4
0 0 1 1 1 0 0 0
0 0 1 2 1 0 0 0
0 0 1 0 1 1 1 1
1 1 1 3 0 3 2 1
1 2 0 3 4 1 1 1
1 1 1 1 3 1 0 0
0 0 0 1 2 1 0 0
0 0 0 1 1 1 0 0
