XXXXXXXX
XOOOOOOX
XOXXXXOX
XOXXXXOX
XOXXXXOX
XOXXXXOX
XOOOOOOX
XXXXXXXX