XXXXXXXX
XXXOXXXX
XXOOXXXX
XXXOXXXX
XXXOXXXX
XXXOXXXX
XXXXXXXX
XXXXXXXX