XXXXXXXX
XXXXXXXX
XOOOOXXX
XXXXOXXX
XOOOOXXX
XOXXXXXX
XOOOOXXX
XXXXXXXX