XXXXXXXX
XXOOOOXX
XXXXXOXX
XXXXXOXX
XXOOOOXX
XXXXXOXX
XXOOOOXX
XXXXXXXX