XXXXXXXX
XXXXOXXX
XOXXOXXX
XOXXOXXX
XOOOOOXX
XXXXOXXX
XXXXOXXX
XXXXXXXX