XXXXXXXX
XOOOOXXX
XOXXXXXX
XOOOOOXX
XXXXXXOX
XXXXXXOX
XOOOOOOX
XXXXXXXX