XXXXXXXX
XOOOOOX
XOXXXXXX
XOOOOOXX
XOXXXXOX
XOXXXXOX
XOOOOOX
XXXXXXXX