XXXXXXXX
XOOOOOXX
XXXXXOXX
XXXXXOXX
XXXXXOXX
XXXXXOXX
XXXXXOXX
XXXXXXXX