XXXXXXXX
XOOOOOOX
XOXXXXOX
XOOOOOOX
XXXXXXOX
XXXXXXOX
XOOOOOOX
XXXXXXXX