00000000
00011000
00000100
00000100
00000000
00000100
00000100
00000000