0
00000000
00111000
01000100
01000100
01000100
00111000
00000000
00000000
1
00000000
00010000
00010000
00010000
00010000
00010000
00010000
00000000
2
00000000
00111100
01000100
00001100
00010000
00100000
00111100
00000000
3
00000000
00011100
00100010
00000010
00001100
00000010
00100010
00011100
4
00000000
00001000
00101000
00101000
00111100
00001000
00001000
00000000
5
00000000
00100000
00111100
00100000
00110000
00001000
00111000
00000000
6
00000000
00001000
00010000
00111000
00100100
00111000
00000000
00000000
7
00000000
00000000
01111100
00001000
00010000
00100000
00100000
00000000
8
00000000
00111000
01000100
00111100
00100010
00100010
00011100
00000000
9
00000000
00111000
01000100
00111100
00000100
01000100
00111000
00000000
