0000000000000
1111110000100
0100010000100
0100010000100
0100011111110
0100010000100
0110010000010
0101111111110
0100011000010
0101111111010
0100001000010
0011111111111
0000000000000